100000000000000000000000
111111111111111111111110
100000000000000100000010
100000011111110100000010
100000010000000100111110
111111111111111100100100
001000010010000100100100
001000010010000100100100
001000010010111100100100
001000010010000000100100
001000010011111111100100
001111110010000000000100
000010000011111111110100
000010000000000000010111
000011111111111111110001
000000000000000000000001