11111100000
10000100010
10000111110
10111100000
11100100000
01000100000
00000111111