11100001111
10100001001
10110000001
10011111111
10000001000
11100001000
00001111000
00000100000
00000111111